11111111
1E00C001
100P0001
10C00001
11111111