11111111
1E00C101
100P0011
10C00101
11111111