1111111111111111111111
10000EC00000C000000P01
1111111110000011011111
1111111111111111111111